1 4 0 1 1 1
2 2 1 1 0 2
2 4 1 1 1 0 1 2 2 2
3 3 2 1 1 2 0 1 1 1 1
5 5 4 4 4 4 4 4 2 2 2 4 4 2 0 4 4 4 2 2 4 4 4 4 4 6 8
3 3 0 6 5 2 2 1 4 3 0
4 4 2 2 3 3 1 2 2 0 1 0 2 1 1 1 3 3
4 4 2 0 1 2 1 2 0 1 1 1 0 1 1 0 2 1
6 6 1 2 1 0 3 4 1 1 1 3 2 0 2 2 2 1 1 1 2 3 2 1 1 0 0 3 3 3 0 4 1 1 2 2 3 3
5 5 3 2 1 1 0 4 4 2 2 1 3 3 2 3 0 3 4 4 2 1 3 4 4 4 0
5 7 2 2 2 2 2 4 3 2 0 2 4 3 0 3 2 4 3 2 2 1 2 2 0 1 2 1 0 4 1 1 1 2 3 3 3
6 6 2 2 1 1 4 4 2 3 1 1 1 3 2 4 0 0 1 3 2 3 4 0 0 1 3 3 1 1 3 3 3 3 1 2 2 4
6 6 2 2 1 1 4 4 2 3 1 1 1 3 2 4 0 0 1 3 2 3 4 0 0 1 3 3 1 1 3 3 3 3 1 2 2 4
7 7 3 3 1 1 1 1 3 3 0 0 2 2 2 2 2 2 2 2 4 4 4 4 4 4 4 4 4 4 4 4 4 4 4 4 4 4 4 4 4
6 6 1 2 2 1 2 2 0 3 3 3 3 3 0 1 1 1 1 2 2 2 2 2 2 2 2 2 2 2 2 2 2 2 2 2 2 2 2 2 2
4 4 0 1 1 1 1 1 0 1 2 2 2 2 2 2 2 2 2 2 2 2 2 2 2 2 2 2 2 2 2 2 2 2 2 2 2 2 2 2 2
5 5 2 2 2 2 2 2 2 2 2 2 2 2 2 0 2 2 2 2 2 2 2 2 2 2 2 2 2 2 2 2 2 2 2 2 2 2 2 2 2
6 6 2 2 2 2 2 2 2 2 2 2 2 2 2 2 2 0 2 2 2 2 2 2 2 2 2 2 2 2 2 2 2 2 2 2 2 2 2 2 2
7 7 3 3 3 3 3 3 3 3 3 3 3 3 3 3 3 0 3 3 3 3 3 3 3 3 3 3 3 3 3 3 3 3 3 3 3 3 3 3 3
8 8 4 4 4 4 4 4 4 4 4 4 4 4 4 4 4 4 4 4 0 4 4 4 4 4 4 4 4 4 4 4 4 4 4 4 4 4 4 4 4 4 4
5 5 1 1 1 1 1 1 1 1 1 1 1 0 1 1 1 1 1 1 1 1 1 1 1 1 1 1 1 1 1 1 1 1 1 1 1 1 1 1 1 1
6 6 2 2 2 2 2 2 2 2 0 2 2 2 2 2 2 2 2 2 2 2 2 2 2 2 2 2 2 2 2 2 2 2 2 2 2 2 2 2 2 2
7 7 3 3 2 2 1 2 2 1 1 1 1 3 3 3 3 0 4 4 4 4 4 4 4 4 4 2 2 2 2 2 2 2 2 2 2
8 8 4 4 3 3 2 2 1 1 1 1 1 1 1 1 3 3 3 3 3 3 3 3 0 2 2 2 2 2 2 2 2 2 2 2 2 2
9 9 5 5 4 4 3 3 2 2 1 1 1 1 1 1 1 1 1 1 1 1 3 3 3 3 3 3 0 4 4 4 4 4 4 4 4 4 4
10 10 6 6 5 5 4 4 3 3 2 2 1 1 1 1 1 1 1 1 1 1 1 1 3 3 3 3 3 3 3 3 0 4 4 4 4 4 4 4 4
11 11 7 7 6 6 5 5 4 4 3 3 2 2 1 1 1 1 1 1 1 1 1 1 1 3 3 3 3 3 3 3 3 3 0 4 4 4 4 4 4
12 12 8 8 7 7 6 6 5 5 4 4 3 3 2 2 1 1 1 1 1 1 1 1 1 1 3 3 3 3 3 3 3 3 3 3 0 4 4 4 4
13 13 9 9 8 8 7 7 6 6 5 5 4 4 3 3 2 2 1 1 1 1 1 1 1 1 1 3 3 3 3 3 3 3 3 3 3 3 0 4 4 4
14 14 10 10 9 9 8 8 7 7 6 6 5 5 4 4 3 3 2 2 1 1 1 1 1 1 1 1 3 3 3 3 3 3 3 3 3 3 3 3 0 4
15 15 11 11 10 10 9 9 8 8 7 7 6 6 5 5 4 4 3 3 2 2 1 1 1 1 1 1 1 3 3 3 3 3 3 3 3 3 3 3 3 0